###############
#.............#
#.............#
#.............#
#.............#
#.###########.#
#.#.........#.#
#.#.#########.#
#.#.....#...#.#
#.#.#.#.#...#.#
#.#.#.#.#...#.#
#.#.#.#.#...#.#
#.............#
#.......@.....#
###############