...S.......S...
#############..
#...........#..
####.###.##....
.###.#########.
.#......#......
.#####.##.####.
..#....#..#....
..####.####.#..
..#.........#..
..#.#.#######..
..#.#.#........
..###.#.######.
..#...#@#.#B#..
..#######.###..