$$$$$$$$$$$$$$$
$..#LLLLLLL#..$
$..#.#.#.#.#..$
$..#.#.#.#.#..$
$..#.#.#.#.#..$
$..#.#.#.#.#..$
$.............$
$.............$
$..........S..$
$.............$
$.............$
$...@.........$
$.....###.....$
$.....#B#.....$
$$$$$$$$$$$$$$$