.@.#LLLLLLL#...
...#LLLLLLL#...
...#.#.#.#.#...
...#.#.#.#.#...
...#.#.#.#.#...
...#.#.#.#.#...
...............
...............
...........S...
...............
...............
...............
......###......
......#B#......
......###......