...S.......S...
#############..
#...........#..
####.###.##....
.###.##########
.#......#......
.#####.##.####.
..#....#..#....
..####.####.###
..#.........#..
..#.#.#######..
..#.#.#........
..###.#.######.
..#...#@#.#B#..
..#######.###..