$$$$$$$$$$$$$$$
$..#.......#..$
$..#.#.#.#.#..$
$..#.#.#.#.#..$
$..#.#.#.#.#..$
$..#.#.#.#.#..$
$..#.......#..$
$..#..#.#..#..$
$..#..#.#..#..$
$..#..#.#..#..$
$..####.####..$
$.............$
$.............$
$.......@.....$
$$$$$$$$$$$$$$$