$$$$$$$$$$$$$$$
$.............$
$.............$
$.............$
$.............$
$.###########.$
$.#LLLLLLLLL#.$
$.#.#.#.#.#.#.$
$.#.......#..#$
$.#.#.#.#.#..#$
$.#.#.#.#.#..#$
$.#.#.#.#.#..#$
$.............$
$.......@.....$
$$$$$$$$$$$$$$$