$$$$$$$$$$$$$$$
$############.$
$#..........#.$
$###.###.##...$
$###.#########$
$#......#.....$
$#####.##.####$
$.#....#..#...$
$.####.####.#.$
$...........#.$
$.#.#.#######.$
$.###.#.......$
$.#.#.#.#####.$
$.....#@#.....$
$$$$$$$$$$$$$$$