...#LLLLLLL#...
...#LLLLLLL#...
...#.#.#.#.#...
...#.#.#.#.#...
...#.#.#.#.#...
...#.#.#.#.#...
...............
...........S...
...............
...............
...............
...............
...............
...@..###......
......#B#......