$$$$$$$$$$$$$$$
$..#LLLLLLL#..$
$..#.#.#.#.#..$
$..#.#.#.#.#..$
$..#.#.#.#.#..$
$..#.#.#.#.#..$
$.............$
$.............$
$.............$
$.............$
$.............$
$.............$
$.............$
$.......@.....$
$$$$$$$$$$$$$$$