...............
...............
...............
...............
...............
..#.#.#S#.#.#..
..#S#.#.#.#S#..
..#LLL#.#LLL#..
..#LLL#.#LLL#..
..#.#.#.#.#.#..
..#.#.#.#.#.#..
...............
...............
...###..@......
...#B#.........