$$$$$$$$$$$$$$$
$.............$
$.............$
$.............$
$.............$
$.#.#.#.#.#.#.$
$.#.#.#.#.#.#.$
$.#LLL#.#LLL#.$
$.#LLL#.#LLL#.$
$.#.#.#.#.#.#.$
$.#.#.#.#.#.#.$
$.............$
$.............$
$.......@.....$
$$$$$$$$$$$$$$$