...#.......#...
...#.....S.#...
...#.#.#.#.#...
...#.#.#.#.#...
...#.#.#.#.#...
...#.#.#.#.#...
...#.......#...
...#..#.#..#...
...#..#.#..#...
...#..#.#..#...
...####.####...
...............
...............
.....###@......
.....#B#.......